#########################################
A     #   #       #     #       #       #
### # # ### # ### # ### ### ### # ##### #
#   # #   # #   #   #   #   # # ###     #
# ### # # # ### ##### ### ### # ### #####
# # # # #   # #   #       #     #   ### #
# # # # ##### ### # ####### ##### ##### #
# #   #         # # #     #   ### ##### #
# ### # ####### # ### ### ### ### ##### #
#   # # #     # #     #   #   #####   # #
### # ### ### # ####### ### ####### # # #
#   #     # # #       # #   #     # # # #
# ######### # ######### # ##### # # # # #
#     #     #           # #     #   #   #
# ### # ################# # # ######### #
# # # #   #                 # #     # # #
# # # # # # ######### ######### ### # # #
#   # # # # #   #   #   # #       # #   #
# ### # # # # # # # ### # # ####### # ###
# #   # # #   # # # #     #     #   #   #
### ### # # ##### # # ######### # ##### #
#   #   # # #   # # #   #     # #     # #
# ####### # # # # # ### # ### # ##### # #
#       #   # #   # #   #   #   #   # # #
# ##### # ### ##### ####### ##### # # # #
#   # # # #       #     #   #     # # # #
### # # # # ########### # ####### # # ###
#     # # # #   #     # # #     # # #   #
####### ### # # # ### # # # ### # # ### #
#   # #     # #   #   #   # #     # #   #
# # # # ##### ##### ##### # ####### # # #
# # # #     #   ###     # #   #     # # #
# # # ####### # ####### # ### # ##### # #
# #   #     # # ###     #     #   #   # #
# ##### ### ### ### ##### ##### ### #####
#   #   # # #   ### #     #   # #   #   #
### # ### # # ##### # ##### # ### ### # #
# #   # #   #   ### #     # #   #     # #
# ##### # ##### ### ####### ### ####### #
#               #           #           B
#########################################
